{
  "width": 20,
  "height": 14,
  "tileSize": 32,
  "tileset": "Textures/tiles.png",
  "solid": [
    2,
    3
  ],
  "triggers": [
    {
      "x": 4,
      "y": 4,
      "type": "town",
      "id": "starter_town"
    },
    {
      "x": 14,
      "y": 9,
      "type": "town",
      "id": "lake_village"
    },
    { "x": 10, "y": 6,  "type": "encounter", "id": "slimes_easy" }
  ],
  "tiles": [
    3,3,3,3,3,3,3,3,3,3,3,3,3,3,3,3,3,3,3,3,
    3,0,0,0,0,0,0,0,0,0,0,0,0,0,0,0,0,0,0,3,
    3,0,0,0,0,0,0,0,0,0,0,0,0,0,0,0,0,0,0,3,
    3,0,0,1,1,1,0,0,0,0,0,0,1,1,1,0,0,0,0,3,
    3,0,0,1,2,1,0,0,0,0,0,0,1,2,1,0,0,0,0,3,
    3,0,0,1,1,1,0,0,0,0,0,0,1,1,1,0,0,0,0,3,
    3,0,0,0,0,0,0,0,0,0,0,0,0,0,0,0,0,0,0,3,
    3,0,0,0,0,0,0,0,0,0,0,0,0,0,0,0,0,0,0,3,
    3,0,0,0,0,0,0,0,2,2,2,0,0,0,0,0,0,0,0,3,
    3,0,0,0,0,0,0,0,2,2,2,0,0,0,0,0,0,0,0,3,
    3,0,0,0,0,0,0,0,2,2,2,0,0,0,0,0,0,0,0,3,
    3,0,0,0,0,0,0,0,0,0,0,0,0,0,0,0,0,0,0,3,
    3,0,0,0,0,0,0,0,0,0,0,0,0,0,0,0,0,0,0,3,
    3,3,3,3,3,3,3,3,3,3,3,3,3,3,3,3,3,3,3,3
  ]
}
